##########
##########
##########
###    ###
### @$ ###
###   .###
###    ###
##########
##########
##########

UDRURD